P,P,B,G,G,G,G,G,B,P,P,P,P,P,P,P,P,P,G,G,G,G,P,B,P,G,G,G,G,G,G,G,G,G,G,G,G,G,G,G,G,G,G,G,G
B,P,B,B,B,B,B,B,B,P,B,B,P,B,B,B,B,P,G,G,G,G,P,B,P,G,G,G,G,G,G,G,G,G,G,G,G,G,G,G,G,G,G,G,G
B,P,P,P,P,P,P,B,B,P,P,B,P,B,G,G,B,P,G,G,G,G,P,B,P,G,G,G,G,G,G,G,G,G,G,G,G,G,G,G,G,G,G,G,G
B,B,B,B,B,B,P,B,B,B,B,B,P,B,G,G,B,P,G,G,G,G,P,B,P,G,G,G,G,G,G,G,G,G,G,G,G,G,G,G,G,G,G,G,G
G,G,P,P,P,B,P,B,G,G,G,B,P,B,G,G,B,P,G,G,G,G,P,B,P,G,G,G,G,G,G,G,G,G,G,G,G,G,G,G,G,G,G,G,G
G,G,P,B,P,B,P,B,B,B,B,B,P,B,G,G,B,P,G,G,G,G,P,B,P,G,G,G,G,G,G,G,G,G,G,G,G,G,G,G,G,G,G,G,G
G,G,P,B,P,B,P,P,P,P,P,P,P,B,G,G,B,P,P,P,P,P,P,B,P,G,G,G,G,G,G,G,G,G,G,G,G,G,G,G,G,G,G,G,G
G,G,P,B,P,B,B,B,B,B,B,B,B,B,B,B,B,P,B,B,B,B,B,B,P,P,P,P,G,G,G,G,G,G,G,G,G,G,G,G,G,G,G,G,G
G,G,P,B,P,P,P,P,P,P,P,P,P,P,P,P,B,P,B,G,G,G,G,B,B,B,B,P,G,G,G,G,G,G,G,G,G,G,G,G,G,G,G,G,G
G,G,P,B,B,B,G,G,G,G,G,G,G,G,G,P,B,P,B,B,B,B,B,B,B,B,B,P,G,G,G,G,G,G,G,G,G,G,G,G,G,G,G,G,G
G,G,P,B,P,B,G,G,G,G,G,G,G,G,G,P,B,P,P,P,P,P,P,P,P,P,P,P,G,G,G,G,G,G,G,G,G,G,G,G,G,G,G,G,G
G,G,P,B,P,B,G,G,G,G,G,G,G,G,G,P,B,B,B,B,B,B,G,G,G,G,G,P,G,G,G,G,G,G,G,G,G,G,G,G,G,G,G,G,G
G,G,P,B,P,B,B,B,B,B,G,G,G,G,G,P,P,P,P,P,P,P,P,P,P,G,G,P,G,G,G,G,G,G,G,G,G,G,G,G,G,G,G,G,G
G,G,P,B,P,P,P,P,P,B,G,G,G,G,G,G,G,G,G,G,G,G,G,G,P,G,G,P,G,G,G,G,G,G,G,G,G,G,G,G,G,G,G,G,G
G,G,P,B,B,B,B,B,P,B,G,G,G,G,G,G,G,G,G,G,G,G,G,G,P,G,G,P,G,G,G,G,G,G,G,G,G,G,G,G,G,G,G,G,G
G,G,P,P,P,P,P,P,P,P,P,G,G,G,G,G,G,G,G,G,G,G,G,G,P,G,G,P,G,G,G,G,G,G,G,G,G,G,G,G,G,G,G,G,G
G,G,G,G,G,G,G,G,G,G,G,G,G,G,G,G,G,G,G,G,G,G,G,G,P,G,G,P,G,G,G,G,G,G,G,G,G,G,G,G,G,G,G,G,G
G,G,G,G,G,G,G,G,G,G,G,G,G,G,G,G,G,G,G,G,G,G,G,G,P,G,G,P,G,G,G,G,G,G,G,G,G,G,G,G,G,G,G,G,G
G,G,G,G,G,G,G,G,G,G,G,G,G,G,G,G,G,G,G,G,G,G,G,G,P,P,P,P,G,G,G,G,G,G,G,G,G,G,G,G,G,G,G,G,G
G,G,G,G,G,G,G,G,G,G,G,G,G,G,G,G,G,G,G,G,G,G,G,G,G,G,G,G,G,G,G,G,G,G,G,G,G,G,G,G,G,G,G,G,G
G,G,G,G,G,G,G,G,G,G,G,G,G,G,G,G,G,G,G,G,G,G,G,G,G,G,G,G,G,G,G,G,G,G,G,G,G,G,G,G,G,G,G,G,G
G,G,G,G,G,G,G,G,G,G,G,G,G,G,G,G,G,G,G,G,G,G,G,G,G,G,G,G,G,G,G,G,G,G,G,G,G,G,G,G,G,G,G,G,G
G,G,G,G,G,G,G,G,G,G,G,G,G,G,G,G,G,G,G,G,G,G,G,G,G,G,G,G,G,G,G,G,G,G,G,G,G,G,G,G,G,G,G,G,G
G,G,G,G,G,G,G,G,G,G,G,G,G,G,G,G,G,G,G,G,G,G,G,G,G,G,G,G,G,G,G,G,G,G,G,G,G,G,G,G,G,G,G,G,G
G,G,G,G,G,G,G,G,G,G,G,G,G,G,G,G,G,G,G,G,G,G,G,G,G,G,G,G,G,G,G,G,G,G,G,G,G,G,G,G,G,G,G,G,G
G,G,G,G,G,G,G,G,G,G,G,G,G,G,G,G,G,G,G,G,G,G,G,G,G,G,G,G,G,G,G,G,G,G,G,G,G,G,G,G,G,G,G,G,G
G,G,G,G,G,G,G,G,G,G,G,G,G,G,G,G,G,G,G,G,G,G,G,G,G,G,G,G,G,G,G,G,G,G,G,G,G,G,G,G,G,G,G,G,G