G,G,G,G,G
G,P,P,P,P
G,P,G,G,G
P,P,G,G,G
G,G,G,G,G